10,11
#,n,n,?,#,n,n,?,n,?,n
#,#,?,1,#,n,n,?,n,?,n
#,n,?,2,#,n,n,?,n,?,n
#,?,n,n,#,n,n,?,n,?,n
#,?,n,n,#,n,n,?,n,?,n
#,n,n,n,#,n,n,n,n,n,n
#,n,n,n,#,n,n,n,n,n,n
#,n,n,n,#,n,n,n,n,n,n
#,n,n,n,n,n,n,n,n,n,n
#,?,?,?,n,n,n,n,#,#,n
